############
#    X    O#
#    P  ####
##         #
############
